62 48 
4  7  4  0  4  0  4  0  4  0  4  0  4  7  4  0  4  7  4  7  4  7  4  7  4  7  4  7  4  7  4  7  4  7  4  7  4  7  4  7  4  7  4  7  4  7  4  7  4  7  4  7  4  7  4  7  4  7  4  7  4  7  4  7  4  7  4  7  4  7  4  7  4  7  4  7  4  7  4  7  4  7  4  7  4  7  4  7  4  7  4  7  4  7  4  7  4  7  4  7  4  7  4  7  4  7  4  7  4  7  4  7  4  7  4  7  4  7  4  7  4  7  4  0  
4  7  4  7  4  7  4  7  4  7  4  7  4  7  4  7  4  7  4  7  4  7  4  7  4  7  4  7  4  7  4  7  4  7  4  7  4  7  4  7  4  7  4  7  4  7  4  7  4  7  4  7  4  7  4  7  4  7  4  7  4  7  4  7  4  7  4  7  4  7  4  7  4  7  4  7  4  7  4  7  4  7  4  7  4  7  4  7  4  7  4  7  4  7  4  7  4  7  4  7  4  7  4  7  4  7  4  7  4  7  4  7  4  7  4  7  4  7  4  7  4  7  4  0  
4  7  4  7  4  7  4  7  4  7  4  7  4  7  4  7  4  7  4  7  4  7  4  7  4  7  4  7  4  7  4  7  4  7  4  7  4  7  4  7  4  7  4  7  4  7  4  7  4  7  4  7  4  7  4  7  4  7  4  7  4  7  4  7  4  7  4  7  4  7  4  7  4  7  4  7  4  7  4  7  4  7  4  7  4  7  4  7  4  7  4  7  4  7  4  7  4  7  4  7  4  7  4  7  4  7  4  7  4  7  4  7  4  7  4  7  4  7  4  7  4  7  4  0  
4  7  4  7  4  7  4  7  4  7  4  7  4  7  4  7  4  7  4  7  4  7  4  7  4  7  4  7  4  7  4  7  4  7  4  7  4  7  4  7  4  7  4  7  4  7  4  7  4  7  4  7  4  7  4  7  4  7  4  7  4  7  4  7  4  7  4  7  4  7  4  7  4  7  4  7  4  7  4  7  4  7  4  7  4  7  4  7  4  7  4  7  4  7  4  7  4  7  4  7  4  7  4  7  4  7  4  7  4  7  4  7  4  7  4  7  4  7  4  7  4  7  4  0  
4  7  4  7  4  7  4  7  4  7  4  7  4  7  4  7  4  7  4  7  4  7  4  7  4  7  4  7  4  7  4  7  4  7  4  7  4  7  4  7  4  7  4  7  4  7  4  7  4  7  4  7  4  7  4  7  4  7  4  7  4  7  4  7  4  7  4  7  4  7  4  7  4  7  4  7  4  7  4  7  4  7  4  7  4  7  4  7  4  7  4  7  4  7  4  7  4  7  4  7  4  7  4  7  4  7  4  7  4  7  4  7  4  0  4  7  4  7  4  7  4  7  4  0  
4  7  4  7  4  7  4  7  4  7  4  7  4  0  4  0  4  0  4  0  4  0  4  0  4  0  4  0  4  0  4  0  4  0  4  0  4  0  4  0  4  0  4  0  4  0  4  0  4  0  4  0  4  0  4  0  4  0  4  0  4  0  4  0  4  0  4  0  4  0  4  0  4  0  4  0  4  0  4  0  4  0  4  0  4  0  4  0  4  0  4  0  4  0  4  0  4  0  4  0  4  0  4  0  4  0  4  0  4  0  4  0  4  7  4  7  4  7  4  7  4  7  4  0  
4  7  4  7  4  7  4  7  4  7  4  7  4  0  3  0  3  0  3  0  3  0  3  0  3  0  3  0  3  0  3  0  3  0  3  0  3  0  3  0  3  0  3  0  3  0  3  0  3  0  3  0  3  0  3  0  3  0  3  0  3  0  3  0  3  0  3  0  3  0  3  0  3  0  3  0  3  0  3  0  3  0  3  0  3  0  3  12  23  1  27  1  27  1  27  1  27  1  27  1  27  1  27  1  22  1  3  12  3  0  4  0  4  0  4  7  4  7  4  7  4  7  4  0  
4  7  4  7  4  7  4  7  4  7  4  7  4  0  3  0  3  0  13  1  17  1  17  1  17  1  17  1  17  1  17  1  17  1  17  1  17  1  17  1  12  1  3  0  3  0  3  10  3  0  13  1  17  1  17  1  17  1  17  1  17  1  17  1  17  1  17  1  12  1  3  0  3  0  3  0  3  0  3  0  3  0  3  0  3  0  4  12  26  1  50  15  50  1  50  43  50  25  50  0  50  0  50  15  26  1  3  12  3  0  4  0  4  7  4  7  4  7  4  7  4  7  4  0  
4  7  4  7  4  7  4  7  4  7  4  7  4  0  3  0  4  0  16  1  10  1  10  28  10  27  10  35  10  1  10  27  10  0  10  0  10  0  10  24  16  1  3  0  3  0  3  0  4  0  16  1  40  1  40  26  40  0  40  0  40  26  40  26  40  0  40  0  16  1  3  0  3  0  3  0  3  0  3  0  3  0  3  0  3  0  4  12  26  1  50  25  50  25  20  25  50  25  20  0  50  0  50  0  26  1  3  12  3  0  4  0  4  7  4  7  4  7  4  7  4  7  4  0  
4  7  4  7  4  7  4  7  4  7  4  7  4  0  3  0  4  0  16  1  10  1  10  1  10  27  41  1  41  1  41  27  10  0  10  0  10  0  10  0  16  1  3  0  3  0  3  0  4  0  16  1  40  1  40  26  40  0  51  0  51  26  51  26  40  0  40  0  16  1  3  0  3  0  3  0  3  0  3  0  3  35  3  0  3  0  4  12  26  1  50  14  50  0  20  0  20  0  20  0  50  0  50  13  26  1  3  12  3  0  4  0  4  7  4  7  4  7  4  7  4  7  4  0  
4  7  4  7  4  7  4  7  4  7  4  7  4  0  3  0  4  0  16  1  10  27  10  27  10  27  41  27  10  27  10  27  41  0  10  0  10  0  10  0  16  1  3  0  3  10  3  0  4  0  16  1  40  1  40  26  51  0  40  0  40  0  40  0  40  0  40  0  51  0  6  0  6  0  6  0  6  0  6  0  6  0  3  0  3  0  4  12  26  1  50  23  50  0  20  0  50  0  20  0  50  0  50  23  26  1  3  12  3  0  4  0  4  7  4  7  4  7  4  7  4  7  4  0  
4  7  4  7  4  7  4  7  4  7  4  7  4  0  3  0  4  0  16  1  10  35  10  0  10  0  41  0  41  0  41  0  10  0  10  0  10  0  10  0  16  1  3  0  3  0  3  0  4  0  16  1  40  42  40  26  40  0  51  0  51  0  40  0  40  0  40  0  51  0  6  0  6  0  6  0  6  0  6  0  6  0  3  0  3  0  4  12  26  1  50  15  50  0  50  0  50  0  50  0  50  0  50  15  26  1  3  12  3  0  4  0  4  7  4  7  4  7  4  7  4  7  4  0  
4  7  4  7  4  7  4  7  4  7  4  7  4  0  3  0  4  0  16  1  10  15  10  0  10  0  41  0  10  0  10  15  10  0  10  0  10  0  10  0  16  1  3  0  3  0  3  0  4  0  16  1  40  1  40  26  40  0  40  0  40  0  51  0  40  0  40  0  16  1  3  0  3  0  3  0  3  0  6  0  6  0  3  0  3  0  4  12  25  1  27  1  27  1  27  1  21  0  21  0  27  1  27  1  24  1  3  12  3  0  4  0  4  7  4  7  4  7  4  7  4  7  4  0  
4  7  4  7  4  7  4  7  4  7  4  7  4  0  3  0  4  0  16  1  10  20  10  0  10  0  41  0  10  0  10  21  10  0  10  0  10  0  10  0  16  1  3  0  3  0  3  10  4  0  16  1  40  1  40  26  51  0  51  0  51  26  40  26  40  0  40  0  16  1  3  0  3  0  3  0  3  0  6  0  6  0  3  0  3  0  4  12  4  12  4  12  4  12  4  12  6  0  6  0  4  12  4  12  4  12  3  12  3  0  4  0  4  7  4  7  4  7  4  7  4  7  4  0  
4  7  4  7  4  7  4  7  4  7  4  7  4  0  3  0  4  0  16  1  10  20  10  0  10  0  10  0  10  0  10  21  10  0  10  0  10  0  10  24  16  1  3  0  3  0  3  0  4  0  16  1  40  1  40  26  40  0  40  0  40  26  40  26  40  0  40  0  16  1  3  0  3  0  3  0  3  0  6  0  6  0  3  0  3  0  3  0  3  0  3  0  3  0  3  0  6  0  6  0  3  0  3  0  3  0  3  0  3  0  4  0  4  7  4  7  4  7  4  7  4  7  4  0  
4  7  4  7  4  7  4  7  4  7  4  7  4  0  3  0  4  0  15  1  17  1  17  1  10  0  10  0  17  1  17  1  17  1  17  1  17  1  17  1  14  1  3  0  3  0  3  0  4  0  15  1  17  1  17  1  17  1  17  1  17  1  17  1  17  1  17  1  14  1  3  0  3  0  3  0  3  0  6  0  6  0  6  0  6  0  6  0  6  0  6  0  6  0  6  0  6  0  6  0  3  0  3  0  3  0  3  0  3  0  4  0  4  7  4  7  4  7  4  7  4  7  4  0  
4  7  4  7  4  7  4  7  4  7  4  7  4  0  3  0  4  0  4  6  4  6  4  6  6  0  6  0  4  6  4  6  4  6  4  6  4  6  4  6  4  6  3  0  3  10  3  0  4  0  4  0  4  0  4  0  4  0  4  0  4  0  4  0  4  0  4  0  4  0  3  0  3  0  3  0  3  0  6  0  6  0  6  0  6  0  6  0  6  0  6  0  6  0  6  0  6  0  6  0  3  0  3  0  3  8  3  0  3  0  4  0  4  7  4  7  4  7  4  7  4  7  4  0  
4  7  4  7  4  7  4  7  4  7  4  7  4  0  3  0  3  0  3  0  3  0  3  0  6  0  6  0  3  0  3  0  3  0  3  0  3  0  3  0  3  0  3  0  3  0  3  0  3  10  3  0  3  0  3  0  4  10  5  0  5  0  5  0  5  0  4  0  3  0  3  0  3  0  3  0  3  0  6  0  6  0  3  0  3  0  3  0  3  0  3  0  3  0  3  0  6  0  6  0  3  0  3  0  3  0  3  0  3  0  4  0  4  7  4  7  4  7  4  7  4  7  4  0  
4  7  4  7  4  7  4  7  4  7  4  7  4  0  3  0  3  0  3  0  3  0  3  0  6  0  6  0  3  0  3  0  3  0  3  0  3  0  3  0  3  0  3  0  3  0  3  0  3  0  3  0  4  0  5  11  6  0  6  0  6  0  6  0  6  0  6  0  5  11  4  0  3  0  3  0  3  0  6  0  6  0  3  0  3  0  3  0  3  0  3  0  3  0  3  0  6  0  6  0  3  0  3  0  3  0  3  0  3  0  4  0  4  7  4  7  4  7  4  7  4  7  4  0  
4  4  4  40  4  41  4  7  4  7  4  7  4  0  3  0  3  0  3  0  3  0  3  0  6  0  6  0  3  0  3  0  3  0  3  0  3  0  3  0  3  0  3  10  3  0  3  0  3  0  4  0  5  0  6  0  6  0  6  0  6  0  6  0  6  0  6  0  6  0  5  0  4  0  3  0  3  0  6  0  6  0  3  0  3  0  3  0  3  7  3  0  3  0  3  0  6  0  6  0  3  32  3  0  3  0  3  0  3  0  4  0  4  7  4  7  4  7  4  7  4  7  4  0  
4  1  4  0  4  0  4  1  4  7  4  7  4  0  3  0  3  0  5  7  3  0  3  0  6  0  6  0  3  0  3  0  3  0  5  7  3  0  3  0  3  0  3  0  3  0  3  0  4  0  5  0  6  0  6  0  6  0  1  1  1  1  1  1  1  1  6  0  6  0  6  39  5  0  4  0  3  0  6  0  6  0  3  0  3  0  3  0  3  0  3  0  3  0  3  0  6  0  6  0  3  0  3  0  3  0  3  0  3  0  4  0  4  7  4  7  4  7  4  7  4  7  4  0  
4  1  4  0  4  0  4  1  4  7  4  7  4  0  3  0  3  0  5  9  3  33  3  0  6  0  6  0  3  0  3  0  3  0  5  9  3  0  3  0  3  0  3  0  3  0  4  0  5  0  6  0  6  0  6  0  1  9  7  1  7  1  7  1  7  1  1  9  6  0  6  0  6  0  5  0  4  0  6  0  6  0  3  0  3  0  3  0  3  0  3  0  3  7  3  0  6  0  6  0  3  0  3  0  3  0  3  0  3  0  4  0  4  7  4  7  4  7  4  7  4  7  4  0  
4  1  4  0  4  0  4  0  4  0  4  0  4  0  3  0  3  0  3  0  3  0  3  0  6  0  6  0  3  0  3  10  3  0  3  0  3  0  3  0  3  0  3  0  3  10  4  35  5  11  6  0  6  0  1  1  7  1  7  1  7  1  7  1  7  1  7  1  1  1  6  0  6  0  5  11  4  0  6  0  6  0  3  0  3  8  3  0  3  0  3  0  3  0  3  0  6  0  6  0  3  0  3  0  3  0  3  7  3  0  4  0  4  7  4  7  4  7  4  7  4  7  4  0  
4  7  4  1  4  1  4  1  4  7  4  7  4  0  3  0  3  10  3  0  3  0  3  0  6  0  6  0  6  0  6  0  6  0  6  0  6  0  6  0  6  0  6  0  6  0  6  0  6  0  6  0  6  0  1  1  7  1  7  1  4  4  4  4  7  1  7  1  1  1  6  0  6  0  6  0  6  0  6  0  6  0  6  0  6  0  6  0  6  0  6  0  6  0  6  0  6  0  6  0  6  0  3  0  3  0  3  0  3  0  4  0  4  7  4  7  4  7  4  7  4  7  4  0  
4  7  4  7  4  7  4  7  4  7  4  7  4  0  3  0  3  0  3  0  3  0  3  0  6  0  6  0  6  0  6  0  6  0  6  0  6  0  6  0  6  0  6  0  6  0  6  0  6  0  6  0  6  0  1  1  7  1  7  1  4  4  4  4  7  1  7  1  1  1  6  0  6  0  6  0  6  0  6  0  6  0  6  0  6  0  6  0  6  0  6  0  6  0  6  0  6  0  6  0  6  0  3  0  3  0  3  0  3  0  4  0  4  7  4  7  4  7  4  7  4  7  4  0  
4  7  4  7  4  7  4  7  4  7  4  7  4  0  3  0  3  0  3  0  3  0  3  0  6  0  6  0  3  0  3  0  3  0  3  0  6  0  6  0  3  0  3  0  3  0  4  0  5  0  6  0  6  0  1  1  7  1  7  1  7  1  7  1  7  1  7  1  1  1  6  0  6  0  5  0  6  0  6  0  3  0  3  0  3  0  3  0  3  0  3  0  3  0  3  0  3  0  6  0  6  0  3  0  3  0  3  0  3  0  4  0  4  7  4  7  4  7  4  7  4  7  4  0  
4  7  4  7  4  7  4  7  4  7  4  7  4  0  3  0  3  0  3  0  3  0  3  0  6  0  6  0  3  10  3  0  3  0  3  0  6  0  6  0  3  0  3  10  3  0  4  0  5  0  6  0  6  0  6  0  1  9  7  1  7  1  7  1  7  1  1  9  6  0  6  0  6  0  5  0  6  0  6  0  3  0  3  0  3  2  3  0  3  0  3  0  3  0  3  0  3  0  6  0  6  0  3  0  3  0  3  8  3  0  4  0  4  7  4  7  4  7  4  7  4  7  4  0  
4  7  4  7  4  7  4  7  4  7  4  7  4  0  3  0  3  0  3  0  3  8  3  0  6  0  6  0  3  0  3  0  3  8  3  0  6  0  6  0  3  0  3  0  3  8  3  0  4  0  5  11  6  0  6  0  6  0  1  1  1  1  1  1  1  1  6  0  6  0  6  0  5  11  4  0  6  0  6  0  3  35  3  0  3  0  3  0  3  0  3  0  3  7  3  0  3  0  6  0  6  0  3  0  3  0  3  0  3  0  4  0  4  7  4  7  4  7  4  7  4  7  4  0  
4  7  4  7  4  7  4  7  4  7  4  7  4  0  3  0  3  0  3  0  3  0  3  0  6  31  6  0  6  0  6  0  6  0  6  0  6  0  6  0  6  0  6  0  6  0  6  0  6  0  6  0  6  0  6  0  6  0  6  0  6  0  6  0  6  0  6  0  6  0  6  0  6  0  6  0  6  0  6  0  6  0  6  0  6  0  6  0  6  0  6  0  6  0  6  0  6  0  6  0  6  0  3  0  3  0  3  0  3  0  4  0  4  7  4  7  4  7  4  7  4  7  4  0  
4  7  4  7  4  7  4  7  4  7  4  7  4  0  3  0  3  0  3  0  3  0  3  0  6  0  6  0  6  0  6  0  6  0  6  0  6  0  6  0  6  0  6  0  6  0  6  0  6  0  6  0  6  0  6  0  6  0  6  0  6  0  6  0  6  0  6  0  6  0  6  0  6  0  6  0  6  0  6  0  6  0  6  0  6  0  6  0  6  0  6  0  6  0  6  0  6  0  6  0  6  0  3  0  3  0  3  0  3  0  4  0  4  7  4  7  4  7  4  7  4  7  4  0  
4  7  4  7  4  7  4  7  4  7  4  7  4  0  3  0  3  0  3  0  3  0  3  0  3  0  3  0  3  0  3  0  3  0  3  0  3  0  3  0  3  0  3  0  6  0  6  0  3  0  3  0  3  0  4  0  4  0  5  0  5  0  5  0  5  0  4  0  4  0  3  0  3  0  3  0  6  0  6  0  3  0  3  0  3  0  3  0  3  0  3  0  3  0  3  0  3  10  6  0  6  0  3  10  3  0  3  0  3  0  4  0  4  7  4  7  4  7  4  7  4  7  4  0  
4  7  4  7  4  7  4  7  4  7  4  7  4  0  3  0  3  12  3  0  3  0  3  12  3  0  3  0  3  0  3  0  3  12  3  0  3  0  3  0  3  0  3  0  6  0  6  0  3  0  3  0  3  0  3  0  3  0  4  0  4  0  4  0  4  0  3  0  3  0  3  0  3  0  3  0  6  0  6  0  3  0  53  1  57  1  57  1  57  1  57  1  57  1  57  1  57  1  21  0  21  0  57  1  57  1  52  1  3  0  4  0  4  7  4  7  4  7  4  7  4  7  4  0  
4  7  4  7  4  7  4  7  4  7  4  7  4  0  3  0  3  0  3  0  3  0  3  0  3  0  3  0  3  0  3  0  3  0  3  0  3  0  3  0  3  0  3  0  6  0  6  0  3  0  3  0  43  1  47  1  47  1  47  1  47  1  47  1  47  1  47  1  47  1  42  1  3  0  3  0  6  0  6  0  3  10  56  1  40  15  30  22  40  23  30  25  40  21  56  1  30  15  40  0  30  0  40  38  30  15  56  1  3  0  4  0  4  7  4  7  4  7  4  7  4  7  4  0  
4  7  4  7  4  7  4  7  4  7  4  7  4  0  3  0  3  0  3  0  53  1  57  1  57  1  57  1  57  1  57  1  57  1  57  1  57  1  52  1  3  0  3  0  6  0  6  0  3  8  4  9  46  1  50  4  50  36  50  25  50  25  50  25  50  25  50  15  50  4  46  1  3  9  3  8  6  0  6  0  6  0  21  0  30  0  40  0  30  0  40  0  30  37  56  1  40  23  30  0  40  0  30  0  40  23  56  1  3  0  4  0  4  7  4  7  4  7  4  7  4  7  4  7  
4  7  4  7  4  7  4  7  4  7  4  7  4  0  3  0  3  0  4  0  56  1  2  1  2  26  2  0  10  0  10  0  2  0  2  0  2  15  56  1  3  11  3  11  6  0  6  0  6  0  6  0  20  0  50  0  50  0  31  0  31  0  31  0  50  0  50  0  50  0  20  0  6  0  6  0  6  0  6  0  6  0  21  0  40  0  30  0  40  0  30  0  40  0  56  1  30  15  40  25  30  25  40  25  30  15  56  1  3  0  4  0  4  7  4  7  4  7  4  7  4  7  4  7  
4  7  4  7  4  7  4  7  4  7  4  7  4  0  3  0  3  0  4  0  56  1  2  34  2  26  10  0  2  0  2  0  10  0  2  0  2  0  41  0  6  0  6  0  6  0  6  0  6  0  6  0  20  0  50  0  50  0  31  0  50  0  50  0  31  0  50  0  50  0  20  0  6  0  6  0  6  0  6  0  3  10  56  1  30  0  40  0  30  0  40  25  30  21  56  1  40  22  30  17  40  1  30  17  40  22  56  1  3  0  4  0  4  7  4  7  4  7  4  7  4  7  4  7  
4  7  4  7  4  7  4  7  4  7  4  7  4  0  3  0  3  0  4  0  56  1  2  1  2  26  10  0  2  0  2  0  2  0  2  0  2  0  41  0  6  0  6  0  6  0  6  0  3  0  4  9  46  1  50  0  50  0  31  0  50  0  50  0  31  0  50  0  50  0  46  1  3  9  3  0  5  0  5  0  3  0  55  1  57  1  57  1  57  1  57  1  57  1  57  1  57  1  57  1  57  1  57  1  57  1  54  1  3  0  4  0  4  7  4  7  4  7  4  7  4  7  4  0  
4  7  4  7  4  7  4  7  4  7  4  7  4  0  3  0  3  0  4  0  56  1  2  29  2  26  10  0  2  0  2  0  10  0  2  0  2  0  56  1  3  11  3  11  3  0  3  0  3  0  4  0  46  1  50  0  50  0  31  0  31  0  31  0  50  0  50  0  50  0  46  1  3  0  3  0  5  0  5  0  3  0  3  0  3  0  3  6  3  5  3  0  3  0  3  6  3  5  3  30  3  0  3  6  3  5  3  0  3  0  4  0  4  7  4  7  4  7  4  7  4  7  4  7  
4  7  4  7  4  7  4  7  4  7  4  7  4  0  3  0  3  0  4  0  56  1  2  1  2  26  2  0  10  0  10  0  2  0  2  0  2  15  56  1  3  0  3  0  3  0  3  0  3  0  4  0  46  1  50  13  50  0  50  20  50  25  50  25  50  19  50  0  50  13  46  1  3  0  3  0  5  0  5  0  5  0  5  0  5  0  5  0  5  0  5  0  5  0  5  0  5  0  5  0  5  0  5  0  5  0  3  0  3  8  4  0  4  7  4  7  4  7  4  7  4  7  4  7  
4  7  4  7  4  7  4  7  4  7  4  7  4  0  3  0  3  0  4  0  55  1  57  1  57  1  57  1  57  1  57  1  57  1  57  1  57  1  54  1  3  0  3  0  3  0  3  0  3  8  4  0  45  1  47  1  47  1  47  1  47  1  47  1  47  1  47  1  47  1  44  1  3  0  3  8  5  0  5  0  5  0  5  0  5  0  5  0  5  0  5  0  5  0  5  0  5  0  5  0  5  0  5  0  5  0  3  0  3  0  4  0  4  7  4  7  4  7  4  7  4  7  4  7  
4  7  4  7  4  7  4  7  4  7  4  7  4  0  3  0  3  0  4  0  4  0  4  0  4  0  4  0  4  0  4  0  4  0  4  0  4  0  4  0  3  0  3  0  3  0  3  0  3  0  4  0  4  5  4  5  4  5  4  5  4  5  4  5  4  5  4  5  4  5  4  5  3  0  3  0  3  0  3  0  3  0  3  0  3  0  3  6  3  5  3  0  3  0  3  6  3  5  3  0  3  0  3  6  3  5  3  0  3  8  4  0  4  7  4  7  4  7  4  7  4  7  4  7  
4  7  4  7  4  7  4  7  4  7  4  7  4  0  3  0  3  0  3  0  3  0  3  0  3  0  3  0  3  0  3  0  3  0  3  0  3  0  3  0  3  0  3  0  3  0  3  0  3  0  3  0  3  0  3  0  3  0  3  0  3  0  3  0  3  0  3  0  3  0  3  0  3  0  3  0  3  0  3  0  3  0  3  0  3  0  3  0  3  0  3  0  3  0  3  0  3  0  3  0  3  0  3  0  3  0  3  0  3  0  4  0  4  7  4  7  4  7  4  7  4  7  4  7  
4  7  4  7  4  7  4  7  4  7  4  7  4  1  4  1  4  1  4  1  4  8  4  1  4  1  4  1  4  1  4  1  4  1  4  1  4  1  4  8  4  1  4  1  4  1  4  1  4  1  4  1  4  1  4  1  4  1  4  1  4  1  4  1  4  1  4  8  4  1  4  1  4  1  4  1  4  1  4  1  4  1  4  1  4  1  4  1  4  1  4  8  4  1  4  1  4  1  4  1  4  8  4  1  4  1  4  1  4  1  4  1  4  7  4  7  4  7  4  7  4  7  4  7  
4  7  4  7  4  7  4  7  4  7  4  7  4  4  4  4  4  4  4  4  4  4  4  4  4  4  4  4  4  4  4  4  4  4  4  4  4  4  4  4  4  4  4  4  4  4  4  4  4  4  4  4  4  4  4  4  4  4  4  4  4  4  4  4  4  4  4  4  4  4  4  4  4  4  4  4  4  4  4  4  4  4  4  4  4  4  4  4  4  4  4  4  4  4  4  4  4  4  4  4  4  4  4  4  4  4  4  4  4  4  4  4  4  7  4  7  4  7  4  7  4  7  4  7  
4  7  4  7  4  7  4  7  4  7  4  7  4  4  4  4  4  4  4  4  4  4  4  4  4  4  4  4  4  4  4  4  4  4  4  4  4  4  4  4  4  4  4  4  4  4  4  4  4  4  4  4  4  4  4  4  4  4  4  4  4  4  4  4  4  4  4  4  4  4  4  4  4  4  4  4  4  4  4  4  4  4  4  4  4  4  4  4  4  4  4  4  4  4  4  4  4  4  4  4  4  4  4  4  4  4  4  4  4  4  4  4  4  7  4  7  4  7  4  7  4  7  4  7  
4  7  4  7  4  7  4  7  4  7  4  7  4  0  4  7  4  7  4  7  4  7  4  7  4  7  4  7  4  7  4  7  4  7  4  7  4  7  4  7  4  7  4  7  4  7  4  7  4  7  4  7  4  7  4  7  4  7  4  7  4  7  4  7  4  7  4  7  4  7  4  7  4  7  4  7  4  7  4  7  4  7  4  7  4  7  4  7  4  7  4  7  4  7  4  7  4  7  4  7  4  7  4  7  4  7  4  7  4  7  4  7  4  7  4  7  4  7  4  7  4  7  4  7  
4  7  4  7  4  7  4  7  4  7  4  7  4  0  4  7  4  7  4  7  4  7  4  7  4  7  4  7  4  7  4  7  4  7  4  7  4  7  4  7  4  7  4  7  4  7  4  7  4  7  4  7  4  7  4  7  4  7  4  7  4  7  4  7  4  7  4  7  4  7  4  7  4  7  4  7  4  7  4  7  4  7  4  7  4  7  4  7  4  7  4  7  4  7  4  7  4  7  4  7  4  7  4  7  4  7  4  7  4  7  4  7  4  7  4  7  4  7  4  7  4  7  4  7  
4  7  4  7  4  7  4  7  4  7  4  7  4  7  4  7  4  7  4  7  4  7  4  7  4  7  4  7  4  7  4  7  4  7  4  7  4  7  4  7  4  7  4  7  4  7  4  7  4  7  4  7  4  7  4  7  4  7  4  7  4  7  4  7  4  7  4  7  4  7  4  7  4  7  4  7  4  7  4  7  4  7  4  7  4  7  4  7  4  7  4  7  4  7  4  7  4  7  4  7  4  7  4  7  4  7  4  7  4  7  4  7  4  7  4  7  4  7  4  7  4  7  4  7  
