48 36 
3  0  3  0  3  0  3  0  3  0  3  0  3  0  3  0  3  0  3  0  3  0  3  0  3  0  3  0  3  0  3  0  3  0  3  0  3  0  3  0  3  0  3  0  3  0  3  0  3  0  3  0  3  0  3  0  3  0  3  0  3  0  3  0  3  0  3  0  3  0  3  0  3  0  1  0  1  0  1  0  1  0  1  0  1  0  1  0  1  0  1  0  3  0  3  0  
3  0  3  0  1  0  1  0  1  0  1  0  1  0  1  0  1  0  1  0  1  0  1  0  1  0  1  0  3  0  3  0  3  0  3  0  1  0  1  0  1  0  1  0  1  0  1  0  1  0  1  0  1  0  1  0  3  0  3  0  3  0  3  0  3  0  3  0  3  0  3  0  4  0  1  0  2  0  2  0  1  0  2  0  2  0  1  0  2  0  1  0  3  0  3  0  
3  0  4  0  1  0  2  0  2  0  2  0  2  0  2  0  2  0  2  0  2  0  2  0  2  0  1  0  3  0  3  0  3  0  4  0  1  0  2  0  2  0  2  0  2  0  2  0  2  0  2  0  2  0  1  0  3  0  3  0  3  0  3  0  3  0  3  0  3  0  3  0  4  0  1  0  2  0  2  0  1  0  2  0  2  0  1  0  2  0  1  0  3  0  3  0  
3  0  4  0  1  0  2  0  2  0  2  0  1  0  1  0  1  0  2  0  2  0  2  0  2  0  1  0  3  0  3  0  3  0  4  0  1  0  2  0  2  0  2  0  2  0  2  0  2  0  2  0  2  0  1  0  3  0  3  0  3  0  3  0  3  0  3  0  3  0  3  0  4  0  1  0  2  0  2  0  1  0  1  0  1  0  1  0  2  0  1  0  3  0  3  0  
3  0  4  0  1  0  2  0  2  0  2  0  1  0  2  0  2  0  1  0  2  0  2  0  2  0  1  0  3  0  3  0  3  0  4  0  1  0  2  0  2  0  2  0  2  0  2  0  2  0  2  0  2  0  6  0  6  0  6  0  6  0  6  0  6  0  6  0  3  0  3  0  4  0  1  0  2  0  2  0  1  0  2  0  2  0  1  0  2  0  1  0  3  0  3  0  
3  0  4  0  1  0  2  0  2  0  2  0  1  0  2  0  2  0  1  0  2  0  2  0  2  0  1  0  3  0  3  0  3  0  4  0  1  0  2  0  2  0  2  0  2  0  2  0  2  0  2  0  2  0  6  0  6  0  6  0  6  0  6  0  6  0  6  0  3  0  3  0  4  0  1  0  2  0  2  0  1  0  2  0  2  0  1  0  2  0  1  0  3  0  3  0  
3  0  4  0  1  0  2  0  2  0  2  0  1  0  1  0  1  0  2  0  2  0  2  0  2  0  1  0  3  0  3  0  3  0  4  0  1  0  2  0  2  0  2  0  2  0  2  0  2  0  2  0  2  0  1  0  3  0  3  0  3  0  3  0  6  0  6  0  3  0  3  0  4  0  1  0  1  0  1  0  1  0  1  0  1  0  1  0  1  0  1  0  3  0  3  0  
3  0  4  0  1  0  2  0  2  0  2  0  1  0  2  0  2  0  2  0  2  0  2  0  2  0  1  0  3  0  3  0  3  0  4  0  1  0  2  0  2  0  2  0  2  0  2  0  2  0  2  0  2  0  1  0  3  0  3  0  3  0  3  0  6  0  6  0  3  0  3  0  4  0  4  0  4  0  4  0  4  0  6  0  6  0  4  0  4  0  4  0  3  0  3  0  
3  0  4  0  1  0  2  0  2  0  2  0  1  0  2  0  2  0  2  0  2  0  2  0  2  0  1  0  3  0  3  0  3  0  4  0  1  0  2  0  2  0  2  0  2  0  2  0  2  0  2  0  2  0  1  0  3  0  3  0  3  0  3  0  6  0  6  0  3  0  3  0  3  0  3  0  3  0  3  0  3  0  6  0  6  0  3  0  3  0  3  0  3  0  3  0  
3  0  4  0  1  0  1  0  1  0  1  0  1  0  1  0  1  0  1  0  1  0  1  0  1  0  1  0  3  0  3  0  3  0  4  0  1  0  1  0  1  0  1  0  1  0  1  0  1  0  1  0  1  0  1  0  3  0  3  0  3  0  3  0  6  0  6  0  6  0  6  0  6  0  6  0  6  0  6  0  6  0  6  0  6  0  3  0  3  0  3  0  3  0  3  0  
3  0  4  0  4  0  4  0  4  0  6  0  6  0  4  0  4  0  4  0  4  0  4  0  4  0  4  0  3  0  3  0  3  0  4  0  4  0  4  0  4  0  4  0  4  0  4  0  4  0  4  0  4  0  4  0  3  0  3  0  3  0  3  0  6  0  6  0  6  0  6  0  6  0  6  0  6  0  6  0  6  0  6  0  6  0  3  0  3  0  3  0  3  0  3  0  
3  0  3  0  3  0  3  0  3  0  6  0  6  0  3  0  3  0  3  0  3  0  3  0  3  0  3  0  3  0  3  0  3  0  3  0  3  0  3  0  3  0  3  0  3  0  3  0  3  0  3  0  3  0  3  0  3  0  3  0  3  0  3  0  6  0  6  0  3  0  3  0  3  0  3  0  3  0  3  0  3  0  6  0  6  0  3  0  3  0  3  0  3  0  3  0  
3  0  3  0  3  0  3  0  3  0  6  0  6  0  3  0  3  0  3  0  3  0  3  0  3  0  3  0  3  0  3  0  3  0  3  0  3  0  3  0  3  0  6  0  6  0  6  0  6  0  6  0  6  0  3  0  3  0  3  0  3  0  3  0  6  0  6  0  3  0  3  0  3  0  3  0  3  0  3  0  3  0  6  0  6  0  3  0  3  0  3  0  3  0  3  0  
3  0  3  0  3  0  3  0  3  0  6  0  6  0  3  0  3  0  3  0  3  0  3  0  3  0  3  0  3  0  3  0  3  0  3  0  3  0  3  0  6  0  6  0  6  0  6  0  6  0  6  0  6  0  6  0  3  0  3  0  3  0  3  0  6  0  6  0  3  0  3  0  3  0  3  0  3  0  3  0  3  0  6  0  6  0  3  0  3  0  3  0  3  0  3  0  
3  0  3  0  3  0  3  0  3  0  6  0  6  0  3  0  3  0  3  0  3  0  3  0  3  0  3  0  3  0  3  0  3  0  3  0  3  0  6  0  6  0  6  0  1  0  1  0  1  0  1  0  6  0  6  0  6  0  3  0  3  0  3  0  6  0  6  0  3  0  3  0  3  0  3  0  3  0  3  0  3  0  6  0  6  0  3  0  3  0  3  0  3  0  3  0  
3  0  3  0  3  0  3  0  3  0  6  0  6  0  3  0  3  0  3  0  3  0  3  0  3  0  3  0  3  0  3  0  3  0  3  0  6  0  6  0  6  0  1  0  7  0  7  0  7  0  7  0  1  0  6  0  6  0  6  0  3  0  3  0  6  0  6  0  3  0  3  0  3  0  3  0  3  0  3  0  3  0  6  0  6  0  3  0  3  0  3  0  3  0  3  0  
3  0  3  0  3  0  3  0  3  0  6  0  6  0  3  0  3  0  3  0  3  0  3  0  3  0  3  0  3  0  3  0  3  0  3  0  6  0  6  0  1  0  7  0  7  0  7  0  7  0  7  0  7  0  1  0  6  0  6  0  3  0  3  0  6  0  6  0  3  0  3  0  3  0  3  0  3  0  3  0  3  0  6  0  6  0  3  0  3  0  3  0  3  0  3  0  
3  0  3  0  3  0  3  0  3  0  6  0  6  0  6  0  6  0  6  0  6  0  6  0  6  0  6  0  6  0  6  0  6  0  6  0  6  0  6  0  1  0  7  0  7  0  1  0  1  0  7  0  7  0  1  0  6  0  6  0  6  0  6  0  6  0  6  0  6  0  6  0  6  0  6  0  6  0  6  0  6  0  6  0  6  0  6  0  3  0  3  0  3  0  3  0  
3  0  3  0  3  0  3  0  3  0  6  0  6  0  6  0  6  0  6  0  6  0  6  0  6  0  6  0  6  0  6  0  6  0  6  0  6  0  6  0  1  0  7  0  7  0  1  0  1  0  7  0  7  0  1  0  6  0  6  0  6  0  6  0  6  0  6  0  6  0  6  0  6  0  6  0  6  0  6  0  6  0  6  0  6  0  6  0  3  0  3  0  3  0  3  0  
3  0  3  0  3  0  3  0  3  0  6  0  6  0  3  0  3  0  3  0  3  0  6  0  6  0  3  0  3  0  3  0  3  0  3  0  6  0  6  0  1  0  7  0  7  0  7  0  7  0  7  0  7  0  1  0  6  0  6  0  3  0  6  0  6  0  3  0  3  0  3  0  3  0  3  0  3  0  3  0  3  0  3  0  6  0  6  0  3  0  3  0  3  0  3  0  
3  0  3  0  3  0  3  0  3  0  6  0  6  0  3  0  3  0  3  0  3  0  6  0  6  0  3  0  3  0  3  0  3  0  3  0  6  0  6  0  6  0  1  0  7  0  7  0  7  0  7  0  1  0  6  0  6  0  6  0  3  0  6  0  6  0  3  0  3  0  3  0  3  0  3  0  3  0  3  0  3  0  3  0  6  0  6  0  3  0  3  0  3  0  3  0  
3  0  3  0  3  0  3  0  3  0  6  0  6  0  3  0  3  0  3  0  3  0  6  0  6  0  3  0  3  0  3  0  3  0  3  0  3  0  6  0  6  0  6  0  1  0  1  0  1  0  1  0  6  0  6  0  6  0  3  0  3  0  6  0  6  0  3  0  3  0  3  0  3  0  3  0  3  0  3  0  3  0  3  0  6  0  6  0  3  0  3  0  3  0  3  0  
3  0  3  0  3  0  3  0  3  0  6  0  6  0  6  0  6  0  6  0  6  0  6  0  6  0  6  0  6  0  6  0  6  0  6  0  6  0  6  0  6  0  6  0  6  0  6  0  6  0  6  0  6  0  6  0  6  0  6  0  6  0  6  0  6  0  6  0  6  0  6  0  6  0  6  0  6  0  6  0  6  0  6  0  6  0  6  0  6  0  6  0  6  0  6  0  
3  0  3  0  3  0  3  0  3  0  6  0  6  0  6  0  6  0  6  0  6  0  6  0  6  0  6  0  6  0  6  0  6  0  6  0  6  0  6  0  6  0  6  0  6  0  6  0  6  0  6  0  6  0  6  0  6  0  6  0  6  0  6  0  6  0  6  0  6  0  6  0  6  0  6  0  6  0  6  0  6  0  6  0  6  0  6  0  6  0  6  0  6  0  6  0  
3  0  3  0  3  0  3  0  3  0  3  0  3  0  3  0  3  0  3  0  3  0  3  0  3  0  3  0  3  0  6  0  6  0  3  0  3  0  3  0  3  0  3  0  3  0  3  0  3  0  3  0  3  0  3  0  3  0  3  0  3  0  6  0  6  0  3  0  3  0  3  0  3  0  3  0  3  0  3  0  3  0  3  0  6  0  6  0  3  0  3  0  6  0  6  0  
3  0  3  0  3  0  3  0  3  0  3  0  3  0  3  0  3  0  3  0  3  0  3  0  3  0  3  0  3  0  6  0  6  0  3  0  3  0  3  0  3  0  3  0  3  0  3  0  3  0  3  0  3  0  3  0  3  0  3  0  3  0  6  0  6  0  3  0  3  0  1  0  1  0  1  0  1  0  1  0  1  0  1  0  6  0  6  0  1  0  1  0  6  0  6  0  
3  0  3  0  3  0  3  0  3  0  3  0  3  0  3  0  3  0  3  0  3  0  3  0  3  0  3  0  3  0  6  0  6  0  3  0  3  0  1  0  1  0  1  0  1  0  1  0  1  0  1  0  1  0  1  0  1  0  3  0  3  0  6  0  6  0  3  0  4  0  1  0  2  0  2  0  2  0  2  0  1  0  2  0  2  0  2  0  2  0  1  0  6  0  6  0  
3  0  3  0  3  0  1  0  1  0  1  0  1  0  1  0  1  0  1  0  1  0  1  0  1  0  3  0  3  0  6  0  6  0  3  0  4  0  1  0  2  0  2  0  2  0  2  0  2  0  2  0  2  0  2  0  1  0  3  0  3  0  6  0  6  0  6  0  6  0  6  0  2  0  2  0  2  0  2  0  1  0  2  0  2  0  2  0  2  0  1  0  6  0  6  0  
3  0  3  0  4  0  1  0  2  0  2  0  2  0  2  0  2  0  2  0  2  0  2  0  1  0  3  0  3  0  6  0  6  0  6  0  6  0  6  0  2  0  2  0  2  0  2  0  2  0  2  0  2  0  2  0  6  0  6  0  6  0  6  0  6  0  6  0  6  0  6  0  2  0  2  0  2  0  2  0  1  0  2  0  2  0  2  0  2  0  1  0  6  0  6  0  
3  0  3  0  4  0  1  0  2  0  2  0  2  0  2  0  2  0  2  0  2  0  2  0  6  0  6  0  6  0  6  0  6  0  6  0  6  0  6  0  2  0  2  0  2  0  2  0  2  0  2  0  2  0  2  0  6  0  6  0  6  0  6  0  6  0  3  0  4  0  1  0  2  0  2  0  2  0  2  0  1  0  2  0  2  0  2  0  2  0  1  0  6  0  6  0  
3  0  3  0  4  0  1  0  2  0  2  0  2  0  2  0  2  0  2  0  2  0  2  0  6  0  6  0  6  0  6  0  6  0  3  0  4  0  1  0  2  0  2  0  2  0  2  0  2  0  2  0  2  0  2  0  1  0  3  0  3  0  6  0  6  0  3  0  4  0  1  0  1  0  1  0  1  0  1  0  1  0  1  0  1  0  1  0  1  0  1  0  6  0  6  0  
3  0  3  0  4  0  1  0  2  0  2  0  2  0  2  0  2  0  2  0  2  0  2  0  1  0  3  0  3  0  3  0  3  0  3  0  4  0  1  0  2  0  2  0  2  0  2  0  2  0  2  0  2  0  2  0  1  0  3  0  3  0  6  0  6  0  3  0  4  0  1  0  2  0  2  0  2  0  2  0  1  0  2  0  2  0  2  0  2  0  1  0  6  0  6  0  
3  0  3  0  4  0  1  0  2  0  2  0  2  0  2  0  2  0  2  0  2  0  2  0  1  0  3  0  3  0  3  0  3  0  3  0  4  0  1  0  2  0  2  0  2  0  2  0  2  0  2  0  2  0  2  0  1  0  3  0  3  0  6  0  6  0  6  0  6  0  6  0  2  0  2  0  2  0  2  0  1  0  2  0  2  0  2  0  2  0  6  0  6  0  6  0  
3  0  3  0  4  0  1  0  1  0  1  0  1  0  1  0  1  0  1  0  1  0  1  0  1  0  3  0  3  0  3  0  3  0  3  0  4  0  1  0  1  0  1  0  1  0  1  0  1  0  1  0  1  0  1  0  1  0  3  0  3  0  6  0  6  0  6  0  6  0  6  0  2  0  2  0  2  0  2  0  1  0  2  0  2  0  2  0  2  0  6  0  6  0  6  0  
3  0  3  0  4  0  4  0  4  0  4  0  4  0  4  0  4  0  4  0  4  0  4  0  4  0  3  0  3  0  3  0  3  0  3  0  4  0  4  0  4  0  4  0  4  0  4  0  4  0  4  0  4  0  4  0  4  0  3  0  3  0  3  0  3  0  3  0  4  0  1  0  2  0  2  0  2  0  2  0  1  0  2  0  2  0  2  0  2  0  1  0  3  0  3  0  
3  0  3  0  3  0  3  0  3  0  3  0  3  0  3  0  3  0  3  0  3  0  3  0  3  0  3  0  3  0  3  0  3  0  3  0  3  0  3  0  3  0  3  0  3  0  3  0  3  0  3  0  3  0  3  0  3  0  3  0  3  0  3  0  3  0  3  0  4  0  1  0  1  0  1  0  1  0  1  0  1  0  1  0  1  0  1  0  1  0  1  0  3  0  3  0  
