48 36 
3  0  3  0  3  0  3  0  3  0  3  0  3  0  3  0  3  0  3  0  3  0  3  0  3  0  3  0  3  0  3  0  3  0  3  0  3  0  3  0  3  0  3  0  3  0  3  0  3  0  3  0  3  0  3  0  3  0  3  0  3  0  3  0  3  0  3  0  3  0  3  0  3  12  23  0  27  0  27  0  27  0  27  0  27  0  27  0  27  0  22  0  3  12  3  0  
3  0  3  0  13  0  17  0  17  0  17  0  17  0  17  0  17  0  17  0  17  0  17  0  17  0  12  0  3  0  3  0  3  10  3  0  13  0  17  0  17  0  17  0  17  0  17  0  17  0  17  0  17  0  12  0  3  0  3  0  3  0  3  0  3  0  3  0  3  0  3  0  4  12  26  0  50  15  50  0  50  0  50  0  50  0  50  0  50  15  26  0  3  12  3  0  
3  0  4  0  16  0  10  24  10  0  10  0  10  0  10  22  10  22  10  0  10  0  10  0  10  24  16  0  3  0  3  0  3  0  4  0  16  0  40  0  40  0  40  0  40  0  40  0  40  0  40  0  40  0  16  0  3  0  3  0  3  0  3  0  3  0  3  0  3  0  3  0  4  12  26  0  50  0  50  0  20  0  50  0  20  0  50  0  50  0  26  0  3  12  3  0  
3  0  4  0  16  0  10  0  10  0  10  0  41  0  41  0  41  0  10  0  10  0  10  0  10  0  16  0  3  0  3  0  3  0  4  0  16  0  40  0  40  0  40  0  51  0  51  0  51  0  40  0  40  0  16  0  3  0  3  0  3  0  3  0  3  0  3  0  3  0  3  0  4  12  26  0  50  14  50  0  20  0  20  0  20  0  50  0  50  13  26  0  3  12  3  0  
3  0  4  0  16  0  10  0  10  0  10  0  41  0  10  0  10  0  41  0  10  0  10  0  10  0  16  0  3  0  3  10  3  0  4  0  16  0  40  0  40  0  51  0  40  0  40  0  40  0  40  0  40  0  51  0  6  0  6  0  6  0  6  0  6  0  6  0  3  0  3  0  4  12  26  0  50  23  50  0  20  0  50  0  20  0  50  0  50  23  26  0  3  12  3  0  
3  0  4  0  16  0  10  0  10  0  10  0  41  0  41  0  41  0  10  0  10  0  10  0  10  0  16  0  3  0  3  0  3  0  4  0  16  0  40  0  40  0  40  0  51  0  51  0  40  0  40  0  40  0  51  0  6  0  6  0  6  0  6  0  6  0  6  0  3  0  3  0  4  12  26  0  50  15  50  0  50  0  50  0  50  0  50  0  50  15  26  0  3  12  3  0  
3  0  4  0  16  0  10  15  10  0  10  0  41  0  10  0  10  15  10  0  10  0  10  0  10  0  16  0  3  0  3  0  3  0  4  0  16  0  40  0  40  0  40  0  40  0  40  0  51  0  40  0  40  0  16  0  3  0  3  0  3  0  3  0  6  0  6  0  3  0  3  0  4  12  25  0  27  0  27  0  27  0  21  0  21  0  27  0  27  0  24  0  3  12  3  0  
3  0  4  0  16  0  10  20  10  0  10  0  41  0  10  0  10  21  10  0  10  0  10  0  10  0  16  0  3  0  3  0  3  10  4  0  16  0  40  0  40  0  51  0  51  0  51  0  40  0  40  0  40  0  16  0  3  0  3  0  3  0  3  0  6  0  6  0  3  0  3  0  4  12  4  12  4  12  4  12  4  12  6  0  6  0  4  12  4  12  4  12  3  12  3  0  
3  0  4  0  16  0  10  20  10  0  10  0  10  0  10  0  10  21  10  0  10  0  10  0  10  24  16  0  3  0  3  0  3  0  4  0  16  0  40  0  40  0  40  0  40  0  40  0  40  0  40  0  40  0  16  0  3  0  3  0  3  0  3  0  6  0  6  0  3  0  3  0  3  0  3  0  3  0  3  0  3  0  6  0  6  0  3  0  3  0  3  0  3  0  3  0  
3  0  4  0  15  0  17  0  17  0  10  0  10  0  17  0  17  0  17  0  17  0  17  0  17  0  14  0  3  0  3  0  3  0  4  0  15  0  17  0  17  0  17  0  17  0  17  0  17  0  17  0  17  0  14  0  3  0  3  0  3  0  3  0  6  0  6  0  6  0  6  0  6  0  6  0  6  0  6  0  6  0  6  0  6  0  3  0  3  0  3  0  3  0  3  0  
3  0  4  0  4  6  4  6  4  6  6  0  6  0  4  6  4  6  4  6  4  6  4  6  4  6  4  6  3  0  3  10  3  0  4  0  4  0  4  0  4  0  4  0  4  0  4  0  4  0  4  0  4  0  4  0  3  0  3  0  3  0  3  0  6  0  6  0  6  0  6  0  6  0  6  0  6  0  6  0  6  0  6  0  6  0  3  0  3  0  3  8  3  0  3  0  
3  0  3  0  3  0  3  0  3  0  6  0  6  0  3  0  3  0  3  0  3  0  3  0  3  0  3  0  3  0  3  0  3  0  3  10  3  0  3  0  3  0  4  10  5  0  5  0  5  0  5  0  4  0  3  0  3  0  3  0  3  0  3  0  6  0  6  0  3  0  3  0  3  0  3  0  3  0  3  0  3  0  6  0  6  0  3  0  3  0  3  0  3  0  3  0  
3  0  3  0  3  0  3  0  3  0  6  0  6  0  3  0  3  0  3  0  3  0  3  0  3  0  3  0  3  0  3  0  3  0  3  0  3  0  4  0  5  11  6  0  6  0  6  0  6  0  6  0  6  0  5  11  4  0  3  0  3  0  3  0  6  0  6  0  3  0  3  0  3  0  3  0  3  0  3  0  3  0  6  0  6  0  3  0  3  0  3  0  3  0  3  0  
3  0  3  0  3  0  3  0  3  0  6  0  6  0  3  0  3  0  3  0  3  0  3  0  3  0  3  0  3  10  3  0  3  0  3  0  4  0  5  0  6  0  6  0  6  0  6  0  6  0  6  0  6  0  6  0  5  0  4  0  3  0  3  0  6  0  6  0  3  0  3  0  3  0  3  7  3  0  3  0  3  0  6  0  6  0  3  0  3  0  3  0  3  0  3  0  
3  0  3  0  3  7  3  0  3  0  6  0  6  0  3  0  3  0  3  0  3  7  3  0  3  0  3  0  3  0  3  0  3  0  4  0  5  0  6  0  6  0  6  0  1  0  1  0  1  0  1  0  6  0  6  0  6  0  5  0  4  0  3  0  6  0  6  0  3  0  3  0  3  0  3  0  3  0  3  0  3  0  6  0  6  0  3  0  3  0  3  0  3  0  3  0  
3  0  3  0  3  0  3  0  3  0  6  0  6  0  3  0  3  0  3  0  3  0  3  0  3  0  3  0  3  0  3  0  4  0  5  0  6  0  6  0  6  0  1  9  7  0  7  0  7  0  7  0  1  9  6  0  6  0  6  0  5  0  4  0  6  0  6  0  3  0  3  0  3  0  3  0  3  0  3  7  3  0  6  0  6  0  3  0  3  0  3  0  3  0  3  0  
3  0  3  0  3  0  3  0  3  0  6  0  6  0  3  0  3  10  3  0  3  0  3  0  3  0  3  0  3  0  3  10  4  0  5  11  6  0  6  0  1  0  7  0  7  0  7  0  7  0  7  0  7  0  1  0  6  0  6  0  5  11  4  0  6  0  6  0  3  0  3  8  3  0  3  0  3  0  3  0  3  0  6  0  6  0  3  0  3  0  3  0  3  7  3  0  
3  0  3  10  3  0  3  0  3  0  6  0  6  0  6  0  6  0  6  0  6  0  6  0  6  0  6  0  6  0  6  0  6  0  6  0  6  0  6  0  1  0  7  0  7  0  4  4  4  4  7  0  7  0  1  0  6  0  6  0  6  0  6  0  6  0  6  0  6  0  6  0  6  0  6  0  6  0  6  0  6  0  6  0  6  0  6  0  3  0  3  0  3  0  3  0  
3  0  3  0  3  0  3  0  3  0  6  0  6  0  6  0  6  0  6  0  6  0  6  0  6  0  6  0  6  0  6  0  6  0  6  0  6  0  6  0  1  0  7  0  7  0  4  4  4  4  7  0  7  0  1  0  6  0  6  0  6  0  6  0  6  0  6  0  6  0  6  0  6  0  6  0  6  0  6  0  6  0  6  0  6  0  6  0  3  0  3  0  3  0  3  0  
3  0  3  0  3  0  3  0  3  0  6  0  6  0  3  0  3  0  3  0  3  0  6  0  6  0  3  0  3  0  3  0  4  0  5  0  6  0  6  0  1  0  7  0  7  0  7  0  7  0  7  0  7  0  1  0  6  0  6  0  5  0  6  0  6  0  3  0  3  0  3  0  3  0  3  0  3  0  3  0  3  0  3  0  6  0  6  0  3  0  3  0  3  0  3  0  
3  0  3  0  3  0  3  0  3  0  6  0  6  0  3  10  3  0  3  0  3  0  6  0  6  0  3  0  3  10  3  0  4  0  5  0  6  0  6  0  6  0  1  9  7  0  7  0  7  0  7  0  1  9  6  0  6  0  6  0  5  0  6  0  6  0  3  0  3  0  3  2  3  0  3  0  3  0  3  0  3  0  3  0  6  0  6  0  3  0  3  0  3  8  3  0  
3  0  3  0  3  0  3  8  3  0  6  0  6  0  3  0  3  0  3  8  3  0  6  0  6  0  3  0  3  0  3  8  3  0  4  0  5  11  6  0  6  0  6  0  1  0  1  0  1  0  1  0  6  0  6  0  6  0  5  11  4  0  6  0  6  0  3  0  3  0  3  0  3  0  3  0  3  0  3  7  3  0  3  0  6  0  6  0  3  0  3  0  3  0  3  0  
3  0  3  0  3  0  3  0  3  0  6  0  6  0  6  0  6  0  6  0  6  0  6  0  6  0  6  0  6  0  6  0  6  0  6  0  6  0  6  0  6  0  6  0  6  0  6  0  6  0  6  0  6  0  6  0  6  0  6  0  6  0  6  0  6  0  6  0  6  0  6  0  6  0  6  0  6  0  6  0  6  0  6  0  6  0  6  0  6  0  6  0  6  0  6  0  
3  0  3  0  3  0  3  0  3  0  6  0  6  0  6  0  6  0  6  0  6  0  6  0  6  0  6  0  6  0  6  0  6  0  6  0  6  0  6  0  6  0  6  0  6  0  6  0  6  0  6  0  6  0  6  0  6  0  6  0  6  0  6  0  6  0  6  0  6  0  6  0  6  0  6  0  6  0  6  0  6  0  6  0  6  0  6  0  6  0  6  0  6  0  6  0  
3  0  3  0  3  0  3  0  3  0  3  0  3  0  3  0  3  0  3  0  3  0  3  0  3  0  3  0  3  0  6  0  6  0  3  0  3  0  3  0  4  0  4  0  5  0  5  0  5  0  5  0  4  0  4  0  3  0  3  0  3  0  6  0  6  0  3  0  3  0  3  0  3  0  3  0  3  0  3  0  3  0  3  3  6  0  6  0  3  3  3  0  6  0  6  0  
3  0  3  0  3  0  3  0  3  0  3  0  3  0  3  0  3  0  3  0  3  0  3  0  3  0  3  0  3  0  6  0  6  0  3  0  3  0  3  0  3  0  3  0  4  0  4  0  4  0  4  0  3  0  3  0  3  0  3  0  3  0  6  0  6  0  3  0  3  0  53  0  57  0  57  0  57  0  57  0  57  0  57  0  50  0  50  0  57  0  52  0  6  0  6  0  
3  0  3  0  3  0  3  0  3  0  3  0  3  0  3  0  3  0  3  0  3  0  3  0  3  0  3  0  3  0  6  0  6  0  3  0  3  0  43  0  47  0  47  0  47  0  47  0  47  0  47  0  47  0  47  0  42  0  3  0  3  0  6  0  6  0  3  0  4  3  56  0  40  24  40  0  41  0  40  15  56  0  40  15  41  0  40  0  40  24  56  0  6  0  6  0  
3  0  3  0  3  0  53  0  57  0  57  0  57  0  57  0  57  0  57  0  57  0  57  0  52  0  3  0  3  0  6  0  6  0  3  8  4  0  46  0  50  4  50  15  50  0  50  0  50  0  50  0  50  15  50  4  46  0  3  0  3  8  6  0  6  0  6  0  6  0  50  0  40  0  40  0  30  0  40  0  56  0  40  0  30  0  40  0  40  0  56  0  6  0  6  0  
3  0  3  0  4  0  56  0  2  22  2  0  2  0  10  0  10  0  2  0  2  0  2  15  56  0  3  11  3  11  6  0  6  0  6  0  6  0  20  0  50  0  50  0  31  0  31  0  31  0  50  0  50  0  50  0  20  0  6  0  6  0  6  0  6  0  6  0  6  0  50  0  40  0  40  0  30  0  40  0  56  0  40  0  30  0  40  0  40  0  56  0  6  0  6  0  
3  0  3  0  4  0  56  0  2  20  2  0  10  0  2  21  2  0  10  0  2  0  2  0  41  0  6  0  6  0  6  0  6  0  6  0  6  0  20  0  50  0  50  0  31  0  50  0  50  0  31  0  50  0  50  0  20  0  6  0  6  0  6  0  6  0  3  0  4  3  56  0  40  0  40  0  30  0  40  0  56  0  40  0  30  0  40  0  40  0  56  0  6  0  6  0  
3  0  3  0  4  0  56  0  2  22  2  0  10  0  2  15  2  0  2  0  2  0  2  0  41  0  6  0  6  0  6  0  6  0  3  0  4  0  46  0  50  0  50  0  31  0  50  0  50  0  31  0  50  0  50  0  46  0  3  0  3  0  6  0  6  0  3  0  4  0  56  0  57  0  57  0  57  0  57  0  57  0  57  0  57  0  57  0  57  0  56  0  6  0  6  0  
3  0  3  0  4  0  56  0  2  20  2  0  10  0  2  21  2  0  10  0  2  0  2  0  56  0  3  11  3  11  3  0  3  0  3  0  4  0  46  0  50  0  50  0  31  0  31  0  31  0  50  0  50  0  50  0  46  0  3  0  3  0  6  0  6  0  3  0  4  3  56  0  40  24  40  0  30  0  40  15  56  0  40  15  30  0  40  0  40  24  56  0  6  0  6  0  
3  0  3  0  4  0  56  0  2  22  2  0  2  0  10  0  10  0  2  0  2  0  2  15  56  0  3  0  3  0  3  0  3  0  3  0  4  0  46  0  50  14  50  0  50  17  50  0  50  17  50  0  50  0  50  13  46  0  3  0  3  0  6  0  6  0  6  0  6  0  50  0  40  0  40  0  30  0  40  0  56  0  40  0  30  0  40  0  40  0  50  0  6  0  6  0  
3  0  3  0  4  0  55  0  57  0  57  0  57  0  57  0  57  0  57  0  57  0  57  0  54  0  3  0  3  0  3  0  3  0  3  8  4  0  45  0  47  0  47  0  47  0  47  0  47  0  47  0  47  0  47  0  44  0  3  0  3  8  6  0  6  0  6  0  6  0  50  0  40  0  40  0  41  0  30  0  56  0  30  0  41  0  40  0  40  0  50  0  6  0  6  0  
3  0  3  0  4  0  4  0  4  0  4  0  4  0  4  0  4  0  4  0  4  0  4  0  4  0  3  0  3  0  3  0  3  0  3  0  4  0  4  5  4  5  4  5  4  5  4  5  4  5  4  5  4  5  4  5  4  5  3  0  3  0  3  0  3  0  3  0  4  3  56  0  40  0  40  0  40  0  40  0  56  0  40  0  40  0  40  0  40  0  56  0  3  3  3  0  
3  0  3  0  3  0  3  0  3  0  3  0  3  0  3  0  3  0  3  0  3  0  3  0  3  0  3  0  3  0  3  0  3  0  3  0  3  0  3  0  3  0  3  0  3  0  3  0  3  0  3  0  3  0  3  0  3  0  3  0  3  0  3  0  3  0  3  0  4  0  55  0  57  0  57  0  57  0  57  0  57  0  57  0  57  0  57  0  57  0  54  0  3  0  3  0  
